SSSSSSSSSSSSSSSS
S---S--EEESSS--S
S---E--S-EE--N-S
S---S--EEESSS--S
SSSSSSSSSSSSSSSS
X
P 2,2